x1x10000000000000000
0.2.2.2.2.2.2.2.2.00
0..................0
02..0.........0...20
0..................0
02.....5555.......20
0..................0
02..0.........0...20
0..................0
02................20
0..................0
02..0.........0...20
0..................0
02.....5555.......20
0..................0
02..0.........0...20
0..................0
02................20
0..2.2.2.2.2.2.2.220
00000000000000000000