x1x10000000000000000
0.0.0.0.0.0.0.0.0..0
0..................0
00.0.0.0..0.0.0.0.00
0..00000000000000000
00.................0
0..................0
00.................0
0..................0
00.................0
0..................0
00.................0
0..................0
0..................0
00.................0
0..................0
00.................0
0..................0
0..................0
00000000000000000000