012341234123410
1.............1
2.............4
3.............3
4.............2
1.............1
2.............4
3.............3
4.............2
1.............1
2.............1
3.............4
4.............3
1.............2
2.............1
012341234123410